*** gpac-h-filters logs (GPAC version 1.1.0-DEV-revUNKNOWN-HEAD ) - test date 29/04/2021 23:35:20 ***


*** Subtest "single": executing "gpac  -mem-track -noprog -for-test -old-arch -no-reassign -p=0 -h filters" ***
Listing 107 supported filters:
inspect: Inspect packets
probe: Probe source
compositor: Compositor
mp4dmx: ISOBMFF/QT demuxer
bifsdec: MPEG-4 BIFS decoder
odfdec: MPEG-4 OD decoder
fin: File input
btplay: BT/XMT/X3D loader
httpin: HTTP input
svgplay: SVG loader
rfimg: JPG/J2K/PNG/BMP reframer
imgdec: PNG/JPG decoder
rfadts: ADTS reframer
rflatm: LATM reframer
rfmp3: MP3 reframer
faad: FAAD decoder
maddec: MAD decoder
xviddec: XVid decoder
rfac3: AC3 reframer
a52dec: A52 decoder
rfamr: AMR/EVRC reframer
oggdmx: OGG demuxer
vorbisdec: Vorbis decoder
theoradec: Theora decoder
m2tsdmx: MPEG-2 TS demuxer
sockin: UDP/TCP input
dvbin: DVB for Linux
mcdec: MediaCodec decoder
lsrdec: MPEG-4 LASeR decoder
safdmx: SAF demuxer
dashin: MPEG-DASH and HLS client
cdcrypt: CENC decryptor
cecrypt: CENC  encryptor
mp4mx: ISOBMFF/QT muxer
rfqcp: QCP reframer
rfh263: H263 reframer
rfmpgvid: M1V/M2V/M4V reframer
nhntr: NHNT reader
nhmlr: NHML parser
rfnalu: AVC/HEVC reframer
m2psdmx: MPEG PS demuxer
avidmx: AVI demuxer
txtin: Subtitle loader
ttxtdec: TTXT/TX3G decoder
vttdec: WebVTT decoder
ttmldec: TTML decoder
rtpin: RTP/RTSP/SDP input
fout: File output
uflatm: Raw AAC to LATM writer
ufadts: ADTS writer
ufmhas: MHAS writer
reframer: Media Reframer
writegen: Stream to file
ufnalu: AVC/HEVC to AnnexB writer
writeqcp: QCP writer
writevtt: WebVTT writer
nhntw: NHNT writer
nhmlw: NHML writer
vobsubdmx: VobSub demuxer
avimx: AVI muxer
aout: Audio output
ufm4v: M4V writer
resample: Audio resampler
vout: Video output
vcrop: Video crop
vflip: Video flip
rfrawvid: RAW video reframer
rfpcm: PCM reframer
jpgenc: JPG encoder
pngenc: PNG encoder
rewind: Audio/Video rewinder
flist: Sources concatenator
m2tsmx: MPEG-2 TS muxer
dasher: DASH and HLS segmenter
tileagg: HEVC tile aggregator
tilesplit: HEVC tile bitstream splitter
pin: pipe input
pout: pipe output
gsfmx: GSF Muxer
gsfdmx: GSF Demuxer
sockout: UDP/TCP output
rfav1: AV1/IVF/VP9 reframer
ufobu: IVF/OBU/annexB writer
nvdec: NVidia decoder
routein: ROUTE input
rtpout: RTP Streamer
rtspout: RTSP Server
httpout: HTTP Server
hevcsplit: HEVC tile splitter
hevcmerge: HEVC Tile merger
rfflac: FLAC reframer
rfmhas: MPEH-H Audio Stream reframer
rfprores: ProRes reframer
tssplit: MPEG Transport Stream splitter
bsrw: Compressed bitstream rewriter
ffdmx: FFMPEG demuxer
ffdec: FFMPEG decoder
ffavin: FFMPEG AV Capture
ffsws: FFMPEG video rescaler
ffenc: FFMPEG encoder
ffmx: FFMPEG muxer
jsf: JavaScript filter
routeout: ROUTE output
rftruehd: TrueHD reframer
cryptin: CryptFile input
cryptout: CryptFile output
dtout: DekTec SDIOut
avgen: AV Counter Generator

